███████████████████████████████████████████████████████████
██ · · · · · · · · · · · · █████ · · · · · · · · · · · · ██
██ · ███████ · █████████ · █████ · █████████ · ███████ · ██
██ · ███████ · █████████ · █████ · █████████ · ███████ · ██
██ · · · · · · · · · · · · · · · · · · · · · · · · · · · ██
██ · █████████████ · █████████████████ · █████████████ · ██
██ · · · · · · ███ · · · · █████ · · · · ███ · · · · · · ██
████████████ · █████████ · █████ · █████████ · ████████████
         ███ · ███ · · · · · · · · · · · ███ · ███         
         ███ · ███ · ██████-----██████ · ███ · ███         
████████████ · ███ · █               █ · ███ · ████████████
 · · · · · · · · · · █               █ · · · · · · · · · · 
████████████ · ███ · █               █ · ███ · ████████████
         ███ · ███ · █████████████████ · ███ · ███         
         ███ · ███ · · · · · · · · · · · ███ · ███         
████████████ · ███ · █████████████████ · ███ · ████████████
██ · · · · · · · · · · · · █████ · · · · · · · · · · · · ██
██ · ███████ · █████████ · █████ · █████████ · ███████ · ██
██ · · · ███ · · · · · · · · · · · · · · · · · ███ · · · ██
██████ · ███ · ███ · █████████████████ · ███ · ███ · ██████
██ · · · · · · ███ · · · · █████ · · · · ███ · · · · · · ██
██ · ███████████████████ · █████ · ███████████████████ · ██
██ · · · · · · · · · · · · · · · · · · · · · · · · · · · ██
███████████████████████████████████████████████████████████
hhghgh